111111111111111111111111111111
100000000000000000000000000101
111101111011101111101111011101
100100001000000010000010000001
101111101111011101110111111101
100000010000000010000000000001
111101110101111111011111010101
100000000001000000000000000101
110111011111010111011111011101
100100000000000100000000000101
100111011101010111110111011101
100000010000000000000P000CE001
111111111111111111111111111111
